ID,Yards,OffensivePlays,TurnOversLost,FumblesLost,FirstDowns,PassesCompleted,PassesAttempted,YardsGainedPassing,InterceptionsThrown,RushingAttempts,YardsGainedRushing,PenaltiesCommitedByTeam,PenaltiesInYards,FirstDownsByPenalty,NumberOfDrives,OppYards,OppOffensivePlays,OppTurnOversLost,OppFumblesLost,OppFirstDowns,OppPassesCompleted,OppPassesAttempted,OppYardsGainedPassing,OppInterceptionsThrown,OppRushingAttempts,OppYardsGainedRushing,OppPenaltiesCommitedByTeam,OppPenaltiesInYards,OppFirstDownsByPenalty,OppNumberOfDrives,Wins
1,5340,1000,31,11,275,298,519,3340,20,437,2000,116,912,17,194,5819,1029,22,13,330,374,549,4092,9,442,1727,87,686,28,189,4
2,6138,1014,25,14,342,328,476,3784,11,508,2354,105,839,31,179,5681,978,31,13,315,371,558,4031,18,392,1650,104,861,34,179,12
3,5362,955,19,13,288,306,494,3361,6,431,2001,100,837,19,172,5323,991,28,9,307,307,521,3216,19,444,2107,79,676,18,177,10
4,5728,1004,17,8,324,334,505,3923,9,467,1805,111,917,34,182,5453,1032,28,7,307,415,646,3976,21,344,1477,116,1063,31,180,12
5,4788,994,26,9,269,328,586,3419,17,358,1369,101,955,36,196,6088,1100,23,11,364,341,535,3832,12,545,2256,101,820,37,191,2
6,5868,1086,28,11,368,383,646,4136,17,399,1732,104,889,42,197,4883,1019,28,14,293,344,547,3365,14,424,1518,123,1010,28,194,7
7,5299,955,15,8,303,310,473,3255,7,436,2044,104,878,32,182,5269,1037,29,7,313,349,607,3698,22,383,1571,110,941,34,183,11
8,5039,1042,24,11,294,320,537,3432,13,473,1607,111,998,26,204,4666,1060,41,12,293,328,618,3232,29,401,1434,107,845,25,200,14
9,5925,1074,24,8,329,362,604,4057,16,448,1868,96,787,20,199,5098,1013,30,12,271,343,601,3763,18,373,1335,90,767,24,194,10
10,4860,969,17,5,261,322,526,3316,12,390,1544,113,823,24,182,6199,1081,12,3,356,375,549,4179,9,504,2020,112,920,29,182,5
11,5013,945,23,8,251,282,500,3356,15,401,1657,112,933,17,190,5244,1033,22,7,299,358,550,3697,15,447,1547,97,839,25,195,6
12,5140,1004,32,10,286,324,536,3301,22,437,1839,103,810,21,202,5365,1031,36,16,303,313,520,3303,20,474,2062,106,887,22,195,8
13,5874,1041,20,10,348,381,569,4179,10,453,1695,92,662,32,177,4789,913,30,15,279,277,445,2809,15,437,1980,123,1005,24,176,12
14,4978,961,35,16,287,309,509,3379,19,397,1599,98,732,28,185,5216,1027,18,6,293,331,545,3507,12,452,1709,111,869,19,184,7
15,4404,1022,42,16,267,309,586,3065,26,384,1339,112,852,31,210,4894,1009,25,10,281,244,434,2592,15,539,2302,107,852,35,205,4
16,5106,1005,24,11,312,335,537,3332,13,426,1774,104,813,22,172,5295,922,17,4,289,297,465,3586,13,428,1709,80,691,25,170,5
17,6047,1051,20,5,348,384,590,4380,15,437,1667,101,897,35,179,4910,940,22,6,270,297,499,3217,16,385,1693,110,1041,24,178,13
18,6178,1001,13,7,356,349,536,4261,6,435,1917,92,775,30,169,5542,1054,27,9,339,333,564,3623,18,449,1919,104,945,27,175,12
19,5072,1017,23,9,282,328,524,3435,14,476,1637,109,878,17,192,4225,936,40,12,236,279,509,3011,28,367,1214,79,580,26,195,13
20,4949,963,39,17,290,372,596,3820,22,304,1129,116,939,29,185,5530,1033,30,18,319,339,511,3520,12,492,2010,102,869,25,185,3
21,5582,1018,27,15,309,334,580,4038,12,398,1544,98,944,24,196,6253,1056,18,8,334,297,502,3780,10,531,2473,98,921,24,199,4
22,5847,1095,21,10,356,339,534,3569,11,513,2278,57,501,25,174,4944,920,22,8,268,288,474,3222,14,415,1722,81,636,14,170,11
23,4490,981,36,14,256,303,534,2959,22,403,1531,98,761,29,185,5504,993,23,10,326,311,497,3589,13,475,1915,86,754,22,185,4
24,5324,1023,30,16,307,354,574,3787,14,412,1537,92,938,25,186,4413,951,20,10,273,299,523,2963,10,391,1450,100,882,26,182,8
25,5826,1059,27,13,323,338,549,3951,14,486,1875,113,955,33,189,4949,985,25,14,266,311,541,3119,11,407,1830,120,897,17,185,10
26,4306,896,27,9,237,248,439,2655,18,421,1651,121,961,24,188,6082,1054,22,8,336,297,502,3712,14,533,2370,96,767,27,184,5
27,5634,1034,27,9,320,304,532,3539,18,468,2095,79,669,21,193,5621,1047,35,12,311,340,559,3590,23,452,2031,91,748,18,193,9
28,6810,996,18,6,384,385,583,4955,12,387,1855,137,1152,37,171,6488,1109,27,12,419,406,632,4374,15,425,2114,107,881,43,174,12
29,4385,927,27,12,265,262,474,2617,15,417,1768,79,601,19,176,6048,1058,20,11,324,366,566,4149,9,457,1899,81,671,19,187,4
30,6676,1054,19,10,355,310,508,4110,9,500,2566,95,846,25,201,6304,1150,31,12,368,408,670,4636,19,443,1668,106,855,29,196,10
31,6026,1020,15,4,337,366,583,4431,11,419,1595,108,927,33,177,5254,997,27,9,282,329,524,3156,18,430,2098,109,996,30,179,9
32,5508,1013,32,13,309,325,546,3427,19,423,2081,70,695,30,195,6362,1132,20,8,368,419,648,4595,12,443,1767,100,1003,20,197,5
33,5598,1047,24,6,334,280,479,2969,18,543,2629,107,922,39,183,4433,910,20,11,241,265,495,2828,9,379,1605,137,1031,23,185,10
34,5725,1041,37,14,327,312,523,3733,23,469,1992,69,611,26,188,4805,976,29,9,269,319,529,3393,20,408,1412,104,862,21,188,8
35,5041,1006,16,11,303,414,588,3836,5,380,1205,103,882,28,174,5038,993,27,13,304,332,548,3327,14,404,1711,99,825,31,177,8
36,5505,1016,36,12,308,356,590,4065,24,402,1440,137,1128,28,197,5283,1013,29,11,298,361,570,3716,18,407,1567,118,881,23,192,8
37,5264,1002,22,8,287,332,557,3550,14,410,1714,130,978,19,182,5482,1041,21,4,327,362,547,3602,17,442,1880,90,758,23,185,7
38,4357,930,31,10,252,230,460,2408,21,435,1949,90,790,26,201,6108,1043,31,16,333,323,508,3800,15,499,2308,130,1001,24,203,5
39,6192,1059,23,13,347,317,507,3810,10,520,2382,115,890,27,183,5249,971,31,15,292,325,559,3679,16,383,1570,90,805,19,177,10
40,5166,1018,20,10,303,308,491,3335,10,487,1831,90,673,31,189,5102,1007,27,8,284,349,596,3599,19,384,1503,117,984,18,185,12
41,5109,1027,34,14,282,337,620,3677,20,365,1432,134,1130,27,218,5206,1038,27,10,290,297,503,3323,17,506,1883,112,910,28,209,6
42,5108,966,40,16,277,365,588,3650,24,346,1458,123,1007,23,181,6311,1002,24,10,356,301,481,3814,14,498,2497,95,786,33,184,4
43,4984,981,26,13,288,293,504,3182,13,440,1802,82,724,37,186,5708,1073,16,6,320,353,600,3974,10,431,1734,121,1045,26,183,7
44,6226,1010,18,11,352,428,617,4653,7,351,1573,101,899,30,168,6152,1031,19,4,375,398,585,4153,15,409,1999,108,1001,34,171,7
45,5336,1008,24,10,300,373,605,3879,14,370,1457,139,1102,33,195,5818,1085,25,11,344,404,641,4140,14,406,1678,104,943,44,191,7
46,4693,1056,36,15,286,335,562,3088,21,452,1605,139,1067,26,191,4549,998,26,15,277,296,525,2958,11,431,1591,110,844,37,190,6
47,5852,1073,20,11,338,341,564,3737,9,473,2115,116,962,37,191,4904,976,31,12,272,363,601,3637,19,337,1267,101,917,33,188,13
48,6506,1105,31,15,371,410,661,4894,16,415,1612,105,848,40,205,5483,1007,26,14,309,320,543,3669,12,423,1814,101,866,31,199,11
49,5957,1015,28,13,341,341,539,4054,15,434,1903,101,854,24,168,4348,964,15,4,264,289,530,2751,11,399,1597,96,777,26,169,12
50,5542,1037,31,9,329,363,574,4002,22,422,1540,96,744,40,200,5079,1042,30,10,309,367,625,3728,20,370,1351,111,960,33,204,10
51,4939,957,24,8,273,310,541,3129,16,379,1810,78,645,18,178,6291,1041,29,16,344,348,522,3748,13,509,2543,81,588,16,181,2
52,5379,964,30,16,294,249,432,2745,14,494,2634,86,662,24,190,5410,1063,31,16,305,415,646,4225,15,379,1185,110,763,16,192,8
53,5962,1026,18,3,336,381,596,4202,15,409,1760,112,1068,29,182,5482,997,23,10,313,381,590,3882,13,369,1600,109,920,34,177,11
54,5084,969,30,14,284,217,395,2412,16,524,2672,109,905,31,184,5207,999,32,13,310,328,517,3526,19,434,1681,129,930,20,185,11
55,5851,975,24,5,322,342,531,4105,19,419,1746,104,815,22,182,4922,1008,29,10,304,342,581,3409,19,381,1513,85,785,23,182,13
56,5900,1029,17,9,349,403,620,4199,8,374,1701,100,827,36,176,5823,987,25,8,329,370,571,4308,17,376,1515,109,964,22,173,10
57,5438,996,16,5,313,282,438,3050,11,527,2388,91,693,15,174,4878,966,33,14,282,289,497,3312,19,432,1566,86,720,26,178,10
58,5401,1088,29,10,333,331,545,3170,19,509,2231,78,640,16,181,5589,968,21,6,297,281,489,3754,15,435,1835,73,589,25,186,7
59,5027,993,31,9,279,338,552,3412,22,406,1615,107,845,31,191,5348,1024,29,12,291,299,513,3269,17,483,2079,91,726,20,189,9
60,5855,1078,23,10,332,316,527,3593,13,527,2262,112,936,38,199,4578,993,33,12,257,289,509,2718,21,429,1860,112,1050,23,205,10
61,5708,1014,35,14,340,349,580,4198,21,398,1510,107,780,36,181,5554,1025,28,10,329,364,580,3987,18,410,1567,119,837,27,186,5
62,5090,1020,29,7,280,266,480,2932,22,493,2158,108,837,21,196,5359,1048,15,2,293,345,586,3947,13,421,1412,92,833,27,192,8
63,5149,960,23,9,297,228,379,2926,14,549,2223,99,876,33,183,4544,998,30,15,275,315,549,3168,15,402,1376,120,1031,21,181,11
64,6461,1032,28,16,348,378,544,4355,12,468,2106,89,787,18,185,5724,1044,39,13,310,330,574,3769,26,435,1955,86,717,24,194,13
65,5845,1037,23,12,346,422,599,4275,11,398,1570,100,852,31,176,5859,1002,17,7,308,417,626,4308,10,332,1551,115,995,22,176,9
66,5766,1030,16,9,330,279,465,3227,7,542,2539,97,756,23,186,5006,985,36,16,295,344,613,3643,20,344,1363,139,989,30,176,13
67,6014,1017,28,13,336,312,535,3852,15,455,2162,143,1195,36,176,5446,1045,23,12,351,378,541,3840,11,466,1606,104,862,39,180,6
68,5769,1003,32,12,344,331,532,3867,20,423,1902,112,982,45,181,5546,1023,7,5,337,344,542,3732,2,444,1814,117,1011,38,181,4
69,6290,1048,28,8,359,366,582,4426,20,436,1864,91,753,28,172,5546,958,21,4,311,299,478,3591,17,448,1955,92,760,23,170,8
70,5587,1058,23,8,321,362,607,3925,15,408,1662,123,988,27,184,5625,1065,20,10,343,344,544,3764,10,491,1861,97,791,37,188,6
71,5501,1013,21,12,310,315,502,3878,9,486,1623,110,887,15,188,4901,926,34,13,275,332,546,3606,21,342,1295,96,793,29,188,12
72,5711,1050,17,9,341,364,563,3942,8,446,1769,88,726,37,176,5612,1038,20,3,327,374,593,3800,17,412,1812,105,950,36,176,6
73,5559,1024,45,18,315,408,635,4154,27,343,1405,120,919,20,189,5025,944,26,14,282,292,461,3209,12,445,1816,99,755,29,181,7
74,5423,1064,25,9,304,383,633,3810,16,404,1613,136,1018,22,193,5497,1005,29,15,320,330,518,3498,14,443,1999,106,854,35,192,6
75,4832,1042,40,26,291,341,557,3035,14,446,1797,107,873,20,186,4825,968,23,6,258,293,490,3557,17,446,1268,84,728,27,196,5
76,5798,999,32,11,315,310,473,3240,21,507,2558,88,699,22,192,5101,1036,32,11,288,326,589,3400,21,413,1701,97,767,25,196,10
77,5840,1016,15,6,321,287,466,3262,9,522,2578,90,791,15,190,4825,985,28,12,285,307,538,3212,16,386,1613,87,751,20,191,14
78,4969,999,24,8,292,287,485,2999,16,470,1970,102,811,30,195,5050,1021,44,20,286,350,592,3423,24,388,1627,78,704,25,195,10
79,6357,1076,22,9,373,390,592,4436,13,466,1921,81,743,37,178,5123,941,28,10,289,300,512,3355,18,398,1768,91,780,16,179,10
80,4280,960,40,18,238,255,464,2694,22,452,1586,94,785,23,211,4646,1022,33,16,271,293,522,2993,17,448,1653,98,782,21,212,7
81,6113,1019,32,12,340,367,555,4267,20,432,1846,80,664,24,173,5385,935,22,10,300,294,471,3423,12,439,1962,81,659,19,175,8
82,5468,1023,14,4,318,350,582,3725,10,409,1743,66,576,39,188,5713,1026,27,12,319,324,536,3711,15,448,2002,112,990,27,183,11
83,5311,1042,30,18,307,371,609,3782,12,380,1529,120,1083,34,178,6067,998,21,10,321,322,511,4012,11,458,2055,108,833,31,179,3
84,5039,982,37,11,289,305,505,3097,26,441,1942,100,769,26,189,5002,977,26,11,276,333,529,3367,15,417,1635,98,786,11,184,6
85,5584,924,20,9,301,312,478,3858,11,421,1726,95,748,18,170,5599,1041,24,9,339,411,605,3958,15,408,1641,78,708,28,169,8
86,4585,1026,40,19,280,325,561,3136,21,413,1449,103,859,25,200,5481,1014,21,12,322,308,490,3486,9,495,1995,107,867,22,195,2
87,3985,921,26,6,233,238,488,2380,20,409,1605,100,669,22,172,5704,1004,31,8,315,286,446,3273,23,541,2431,95,770,14,171,4
88,5568,1018,26,9,313,323,503,3421,17,492,2147,102,812,27,191,5749,1067,26,6,337,365,608,3888,20,439,1861,105,876,35,184,10
89,5771,988,22,10,328,284,490,3683,12,462,2088,98,835,34,175,5329,1010,23,12,326,371,555,3568,11,416,1761,86,711,32,176,7
90,6192,1080,41,18,350,337,558,3685,23,473,2507,137,1139,20,191,5769,963,23,7,315,335,542,4103,16,394,1666,100,824,34,187,6
91,5972,1011,22,6,356,378,563,3836,16,416,2136,92,818,27,173,5651,948,23,10,315,353,529,3847,13,384,1804,91,805,20,171,7
92,4638,878,23,10,252,292,455,2900,13,371,1738,108,978,24,184,6257,1024,28,7,350,335,508,3932,21,485,2325,107,856,39,183,7
93,4470,998,33,12,259,312,543,2686,21,411,1784,100,834,21,181,5965,1016,20,12,333,315,491,3764,8,500,2201,80,613,24,184,1
94,5120,1026,18,12,295,318,510,3025,6,478,2095,83,644,21,178,4621,933,18,5,259,290,511,3095,13,398,1526,80,639,14,176,8
95,5324,913,23,8,278,316,477,3500,15,406,1824,125,1142,21,189,6122,1088,25,9,349,368,591,3875,16,464,2247,109,919,41,194,10
96,5739,1020,19,5,357,355,551,4033,14,446,1706,67,515,26,166,4475,980,37,15,288,325,498,2764,22,454,1711,85,722,15,162,13
97,5738,1006,31,13,318,364,547,4047,18,401,1691,120,1130,44,192,5712,976,19,12,307,345,519,3990,7,421,1722,144,1164,35,182,4
98,5488,990,17,9,305,365,546,3740,8,412,1748,109,848,22,178,5896,1063,33,15,342,350,598,3958,18,437,1938,109,797,31,182,12
99,6357,1053,29,10,354,382,598,4449,19,441,1908,116,950,28,182,5541,967,15,7,307,314,518,3663,8,409,1878,112,942,34,181,10
100,5640,1042,16,5,314,334,560,3739,11,444,1901,121,1127,34,193,5615,1086,25,12,326,335,557,3650,13,492,1965,107,929,34,192,10
101,5184,1012,21,8,309,228,358,2720,13,618,2464,99,835,28,179,4134,882,32,13,248,269,484,2835,19,357,1299,104,875,23,174,15
102,4609,968,34,15,266,257,450,2792,19,487,1817,103,913,22,192,4787,1014,36,14,283,319,529,3335,22,441,1452,98,766,30,194,10
103,6000,965,15,2,343,292,477,3622,13,462,2378,75,700,24,178,6248,1081,31,13,367,403,616,4181,18,431,2067,100,827,20,182,8
104,5687,968,21,6,327,323,539,3825,15,409,1862,72,578,37,176,6134,1016,35,14,317,341,534,4068,21,449,2066,102,900,17,175,9
105,5610,974,18,8,311,259,405,3031,10,536,2579,110,890,29,170,4899,968,31,13,295,327,564,3250,18,368,1649,102,902,29,169,11
106,5007,1001,26,7,278,357,594,3567,19,349,1440,70,598,12,194,5750,1106,24,6,327,344,580,3752,18,484,1998,95,748,21,194,8
107,5369,1055,27,15,330,326,527,3400,12,499,1969,98,940,28,189,4710,950,35,13,264,294,518,3203,22,388,1507,102,918,33,182,12
108,4851,959,15,6,275,268,462,2762,9,455,2089,89,685,14,178,5335,1042,27,13,324,314,519,3264,14,487,2071,96,717,24,176,6
109,4832,1005,29,16,277,329,536,3109,13,416,1723,121,1112,21,180,4983,970,17,6,288,312,499,3113,11,434,1870,92,735,37,181,5
110,5078,990,25,12,287,280,469,3091,13,469,1987,85,779,32,195,5522,1043,19,3,310,350,590,3992,16,412,1530,112,975,24,195,6
111,4950,964,26,10,278,269,449,3271,16,487,1679,91,732,39,190,4522,981,42,19,262,305,528,3057,23,408,1465,128,1045,30,187,11
112,5226,1052,24,9,289,287,498,2946,15,507,2280,109,932,23,186,5235,976,13,7,300,345,538,3746,6,393,1489,91,780,32,183,4
113,5233,1005,29,10,322,396,609,3792,19,355,1441,113,997,37,180,6033,1008,24,10,325,366,548,4230,14,421,1803,106,978,20,177,5
114,5002,940,18,6,289,293,437,2975,12,456,2027,82,727,27,166,5334,1001,17,6,298,337,533,3471,11,429,1863,120,984,18,172,9
115,5325,1028,24,8,313,324,538,3188,16,466,2137,100,805,30,191,6034,1056,27,10,326,375,607,4295,17,410,1739,103,854,30,196,8
116,5225,991,26,11,308,311,536,3643,15,422,1582,123,1020,31,182,5382,1021,38,12,307,303,513,3478,26,474,1904,117,1078,32,187,7
117,4810,945,26,7,261,226,447,2596,19,469,2214,94,803,23,187,5915,1062,28,11,329,335,530,3602,17,506,2313,102,906,27,189,8
118,5166,965,36,14,303,368,587,3878,22,324,1288,100,676,27,189,6042,1087,35,18,363,422,602,4131,17,448,1911,113,897,26,193,7
119,5999,1135,20,11,367,334,556,3558,9,547,2441,116,940,30,177,4687,974,17,5,286,337,577,3360,12,354,1327,113,1017,30,179,10
120,5096,1020,23,10,273,363,579,3614,13,402,1482,124,1031,22,197,4995,1027,30,11,302,337,559,3292,19,414,1703,104,849,42,198,9
121,4761,920,22,11,241,273,473,2805,11,429,1956,122,1057,23,196,5885,1091,26,13,320,399,597,4065,13,453,1820,109,992,30,198,7
122,6846,1191,16,7,444,402,641,4662,9,523,2184,97,840,37,185,5972,1046,41,21,340,369,594,4342,20,415,1630,101,932,33,196,12
123,5697,984,19,7,297,382,583,4047,12,354,1650,114,951,18,177,5942,1034,21,5,346,362,560,4044,16,444,1898,110,919,38,181,5
124,5198,1026,30,14,274,291,556,3300,16,444,1898,132,1055,22,202,5078,1078,31,17,319,323,549,3307,14,480,1771,105,827,42,196,9
125,5954,1046,20,11,321,288,467,3506,9,546,2448,99,852,14,191,4571,960,27,10,270,279,538,3035,17,378,1536,88,686,31,188,10
126,6180,1056,11,9,351,368,550,4308,2,482,1872,93,819,39,182,5223,998,23,10,294,368,596,3806,13,368,1417,113,930,23,179,14
127,6461,1096,20,8,381,460,667,4970,12,397,1491,130,1112,36,182,6615,997,22,13,380,372,544,4544,9,422,2071,114,887,54,180,7
128,6293,1060,21,10,373,378,544,4328,11,486,1965,95,765,39,167,5864,959,17,6,327,364,548,4139,11,376,1725,100,850,21,166,9
129,5302,1041,34,14,321,302,544,3154,20,469,2148,77,652,35,189,4880,984,25,10,288,306,523,3317,15,408,1563,118,874,20,193,10
130,4813,987,24,9,248,336,555,3293,15,385,1520,105,891,14,194,5688,1042,28,12,320,336,536,3655,16,481,2033,91,808,25,187,4
131,4149,1002,23,8,251,240,469,2179,15,489,1970,77,680,26,194,5008,979,28,11,268,326,513,3341,17,435,1667,105,895,20,195,5
132,4918,1090,29,6,295,363,619,3590,23,423,1328,112,942,38,207,5368,1032,24,8,284,314,552,3681,16,440,1687,126,1196,29,204,8
133,5035,944,22,11,302,279,484,3020,11,417,2015,96,817,41,187,5307,1058,26,13,306,337,559,3236,13,461,2071,129,1105,19,187,12
134,6237,1069,19,9,366,418,619,4475,10,414,1762,129,1094,27,171,4979,997,31,10,319,346,570,3526,21,384,1453,103,787,34,181,11
135,5952,1097,36,14,343,350,551,3832,22,512,2120,90,712,24,196,4835,982,36,17,279,336,573,3460,19,359,1375,106,927,24,188,10
136,4987,1037,34,17,306,288,464,2878,17,543,2109,101,773,17,189,4665,978,34,12,268,349,569,3187,22,369,1478,90,745,23,183,10
137,5419,1036,24,12,312,314,544,3423,12,459,1996,92,742,33,186,4622,1002,26,11,269,288,535,3140,15,419,1482,103,1032,24,188,12
138,4778,1008,32,9,283,271,499,2794,23,468,1984,116,992,38,193,4706,968,27,11,293,313,492,2867,16,440,1839,99,976,25,189,6
139,3572,947,29,14,208,235,447,2225,15,424,1347,136,1011,30,201,5230,1056,21,11,291,281,512,3141,10,509,2089,102,955,20,210,4
140,5601,1040,23,11,361,394,595,3729,12,399,1872,81,635,36,181,5494,1029,25,11,309,338,537,3557,14,453,1937,105,920,16,180,8
141,4672,936,33,13,263,301,531,3297,20,353,1375,118,939,29,180,5903,1067,25,11,353,387,563,4084,14,468,1819,106,935,27,185,2
142,5069,1045,31,12,297,372,609,3503,19,395,1566,95,840,33,194,5703,1024,23,10,305,374,568,3927,13,428,1776,111,971,21,196,5
143,5423,989,23,9,293,266,446,2882,14,513,2541,97,810,19,188,4538,978,24,4,259,294,523,3078,20,420,1460,80,684,22,187,8
144,5358,1024,31,14,305,303,515,3285,17,481,2073,108,895,24,183,4657,976,27,12,276,303,510,3251,15,442,1406,103,881,20,182,5
145,5871,1060,19,9,357,300,501,3589,10,526,2282,103,887,24,198,5167,1058,39,15,298,390,650,3752,24,364,1415,99,822,26,196,15
146,5728,1008,18,7,322,307,504,3541,11,476,2187,110,1012,32,184,5720,1031,18,6,324,388,635,4307,12,356,1413,137,1191,27,177,9
147,5710,1055,14,6,334,357,527,3753,8,501,1957,100,949,38,185,4415,956,19,5,260,324,555,3078,14,364,1337,105,928,33,179,13
148,5392,1010,30,15,318,271,455,2890,15,530,2502,103,859,24,191,4656,974,30,9,285,294,520,3102,21,407,1554,106,826,37,188,9
149,5848,1073,13,4,361,392,609,4121,9,438,1727,120,1080,37,181,5506,1033,25,9,329,342,574,3837,16,419,1669,92,752,45,182,12
150,5618,1012,21,8,299,343,541,3813,13,437,1805,110,984,18,179,5349,1003,28,6,295,287,518,3244,22,458,2105,89,721,33,192,6
151,6386,1036,38,13,356,330,554,4110,25,450,2276,107,853,25,190,5198,982,24,9,289,301,518,3397,15,414,1801,97,813,32,195,8
152,4976,983,25,11,296,338,567,3264,14,350,1712,95,736,32,180,6279,1067,13,3,364,347,543,3996,10,498,2283,104,930,23,179,1
153,5541,976,29,14,305,326,515,3584,15,429,1957,90,610,22,177,5376,992,30,16,306,279,458,3094,14,501,2282,82,628,19,176,7
154,4692,1035,34,13,266,327,569,3362,21,423,1330,111,839,24,205,5675,1036,33,17,305,343,541,3708,16,454,1967,92,670,20,214,7
155,4563,1003,35,13,274,291,548,2740,22,414,1823,76,617,32,188,6020,1046,25,8,335,335,535,3874,17,490,2146,111,969,22,187,5
156,5214,1003,28,10,304,301,523,3058,18,455,2156,101,881,21,190,5479,1057,28,11,314,333,567,3649,17,458,1830,97,771,19,187,8
157,5379,995,24,14,300,382,556,3751,10,387,1628,110,965,17,176,6102,973,17,3,317,299,480,3853,14,480,2249,117,991,31,174,4
158,5421,981,15,5,329,388,594,4111,10,350,1310,100,861,36,156,5676,964,14,4,333,399,549,3975,10,389,1701,122,979,28,160,9
159,5563,1079,23,7,316,439,679,4100,16,367,1463,125,1111,32,191,5154,993,28,10,294,369,578,3724,18,384,1430,94,900,30,192,8
160,4716,985,23,9,268,303,487,2890,14,457,1826,131,1085,24,190,4444,950,30,13,254,275,476,2929,17,438,1515,108,830,31,184,11
161,3816,967,37,21,230,249,471,2192,16,430,1624,124,956,25,207,5390,1046,29,12,302,287,515,3340,17,496,2050,120,914,28,216,5
162,5400,1023,24,10,312,377,586,4017,14,394,1383,80,677,24,189,5395,1036,20,10,303,329,569,3546,10,433,1849,92,798,23,190,8
163,5891,1097,30,10,330,364,587,4136,20,481,1755,102,1000,24,201,4888,1042,31,11,282,362,614,3344,20,385,1544,69,692,32,197,11
164,6366,1090,25,14,380,402,588,4534,11,481,1832,100,805,36,188,4652,1015,24,8,287,321,559,3194,16,404,1458,123,951,31,193,13
165,5161,1062,29,8,286,294,510,3162,21,515,1999,98,837,22,203,4056,937,25,12,228,239,492,2631,13,413,1425,88,763,33,197,10
166,5118,1051,45,15,318,383,626,3766,30,398,1352,119,918,36,189,4690,969,21,11,280,252,430,2680,10,504,2010,98,975,30,192,4
167,5852,998,30,15,328,418,630,4674,15,340,1178,107,781,25,178,5304,993,30,17,312,323,517,3540,13,445,1764,98,816,23,181,9
168,4375,948,34,18,237,252,471,2621,16,423,1754,105,974,21,203,5267,1079,30,11,291,334,574,3449,19,481,1818,119,919,23,209,5
169,4972,938,17,4,304,331,542,3290,13,359,1682,114,957,30,166,6618,1084,18,6,372,389,584,4414,12,466,2204,113,944,26,177,6
170,5410,1116,27,12,301,299,522,3103,15,546,2307,110,954,39,214,5334,1089,30,7,308,310,561,3271,23,471,2063,108,931,40,214,6
171,5197,1004,37,14,296,308,519,3428,23,449,1769,105,867,24,187,5285,960,22,9,297,310,502,3521,13,425,1764,104,879,29,185,6
172,5169,1020,25,14,290,339,570,3685,11,410,1484,119,985,33,198,5057,1076,27,13,306,306,552,2972,14,482,2085,110,990,36,197,9
173,5604,1073,24,13,311,318,548,3384,11,489,2220,111,897,23,200,4754,1009,38,23,272,333,563,3094,15,390,1660,112,969,29,194,12
174,6259,1000,18,10,332,386,536,4189,8,444,2070,105,967,20,175,5384,1002,25,5,308,329,554,3597,20,406,1787,108,850,44,177,11
175,5761,972,17,7,330,338,519,4338,10,427,1423,78,570,28,170,5232,991,25,11,309,326,534,3348,14,422,1884,103,795,20,168,13
176,5722,1035,27,13,344,293,485,3588,14,524,2134,101,822,31,178,4972,988,36,16,290,315,538,3400,20,405,1572,118,1014,30,175,14
177,6090,1057,27,7,357,359,554,3824,20,457,2266,104,877,33,181,4826,985,22,13,298,360,566,3337,9,379,1489,99,829,22,177,9
178,5225,1021,29,16,313,247,451,2679,13,531,2546,114,1043,25,190,5200,1001,29,13,319,320,526,3137,16,438,2063,114,981,30,190,8
179,6131,994,14,6,341,291,442,3422,8,519,2709,116,985,26,183,6043,1031,31,10,340,393,636,4511,21,363,1532,100,811,28,183,10
180,4784,1037,41,9,281,316,585,3168,32,409,1616,98,768,31,194,6274,1029,23,14,332,371,545,4249,9,458,2025,113,944,24,192,2
181,5167,971,31,12,290,297,525,3021,19,417,2146,126,1016,27,191,5593,1072,20,7,326,322,524,3375,13,518,2218,110,1006,24,191,4
182,5116,993,17,5,302,320,568,3808,12,397,1308,91,707,44,181,5891,1010,25,7,300,365,579,4152,18,396,1739,130,1192,28,188,11
183,4434,919,21,7,248,263,445,2634,14,448,1800,78,633,16,177,5807,1047,30,12,322,354,567,3814,18,454,1993,73,567,15,172,7
184,6482,988,14,6,353,376,552,4924,8,395,1558,76,591,34,180,6585,1049,38,7,358,390,637,4796,31,383,1789,122,948,16,183,15
185,5205,1001,30,15,291,291,538,3441,15,426,1764,119,911,31,192,5796,1071,38,18,327,343,593,3805,20,439,1991,110,953,28,196,9
186,5085,1031,24,10,304,374,605,3577,14,395,1508,108,895,21,185,5377,1032,29,11,315,314,531,3179,18,467,2198,99,928,28,187,9
187,5830,1037,22,7,351,370,584,4202,15,409,1628,103,883,38,180,6126,1024,17,9,353,378,582,4200,8,409,1926,125,1155,35,176,8
188,5460,1019,33,12,330,291,469,3065,21,512,2395,83,675,21,177,5949,948,18,5,316,329,506,4004,13,416,1945,85,748,21,174,8
189,6008,1017,21,9,327,376,570,4201,12,408,1807,114,816,17,185,5491,972,25,10,305,336,545,3906,15,385,1585,85,650,28,180,8
190,5535,1038,27,15,316,268,479,3167,12,523,2368,105,931,30,189,5334,1002,39,15,288,285,514,3287,24,441,2047,112,920,20,190,9
191,5184,1058,21,9,300,261,433,2808,12,592,2376,103,785,21,194,4177,928,34,8,228,276,528,2875,26,366,1302,114,792,18,195,11
192,6577,1068,21,11,379,411,612,4825,10,423,1752,103,834,38,174,5654,944,21,10,314,350,543,4049,11,368,1605,97,835,33,174,11
193,5122,1022,26,12,279,358,594,3597,14,397,1525,125,1002,16,193,5110,960,20,11,294,296,470,3216,9,449,1894,95,718,25,195,4
194,4515,994,29,13,248,365,629,3275,16,337,1240,116,939,19,198,5721,1041,14,5,320,343,538,3810,9,481,1911,116,941,35,197,3
195,5915,1020,17,7,361,307,474,3458,10,519,2457,94,846,27,185,5069,1041,27,11,295,331,571,3559,16,420,1510,123,909,23,187,13
196,5595,938,19,7,287,246,414,3158,12,504,2437,94,637,17,192,5299,1026,25,13,296,333,557,3387,12,432,1912,88,736,18,185,12
197,3797,925,34,17,218,274,513,2320,17,357,1477,97,702,13,203,5539,1078,22,10,308,345,543,3643,12,504,1896,89,661,27,197,5
198,5202,1071,31,14,318,300,500,3341,17,521,1861,99,739,44,194,4814,946,26,11,256,271,495,3083,15,414,1731,142,1015,19,190,9
199,5458,1097,17,8,353,361,577,3567,9,497,1891,58,598,42,178,5319,957,31,9,284,364,560,3625,22,366,1694,116,1003,14,180,13
200,4756,988,26,11,293,338,528,3295,15,411,1461,103,796,28,180,5223,1012,28,14,316,347,568,3681,14,406,1542,102,798,30,182,7
201,5818,1050,28,12,347,361,587,4078,16,430,1740,100,792,35,179,5852,1083,30,11,356,321,555,3411,19,500,2441,99,816,25,177,7
202,6848,1082,17,5,399,402,612,5084,12,438,1764,87,815,30,180,6577,1064,34,11,370,386,619,4703,23,405,1874,115,907,24,181,13
203,4792,1020,28,11,275,306,532,3304,17,446,1488,111,1005,24,192,4783,968,25,11,270,294,484,3042,14,449,1741,96,709,26,195,6
204,7474,1117,19,5,416,472,662,5347,14,431,2127,99,851,20,175,5895,1010,16,7,326,362,626,4157,9,351,1738,109,912,38,182,13
205,6264,1075,23,10,330,372,580,4503,13,472,1761,79,597,24,190,4917,930,19,8,262,267,474,2854,11,418,2063,89,674,18,189,10
206,5229,975,20,12,281,316,490,3357,8,449,1872,81,614,21,185,4451,977,35,19,258,297,490,2725,16,454,1726,86,706,7,182,9
207,4550,938,30,13,241,297,497,3047,17,395,1503,99,770,16,178,5069,1021,23,8,292,279,471,2867,15,527,2202,97,716,15,179,6
208,4943,1025,32,12,272,332,540,3123,20,442,1820,123,903,25,197,4803,977,36,15,272,355,599,3818,21,348,985,112,899,27,192,6
209,5719,1022,21,13,328,288,469,3328,8,522,2391,76,594,21,169,5021,970,30,10,286,319,543,3416,20,390,1605,82,636,13,171,11
210,5143,1004,26,14,310,272,450,3000,12,513,2143,76,577,21,182,5262,999,30,15,298,314,506,3334,15,461,1928,85,709,18,182,9
211,4760,1026,37,9,281,333,574,3233,28,404,1527,94,794,23,193,5457,999,27,9,316,318,523,3613,18,445,1844,95,732,21,191,3
212,5035,957,27,11,288,327,515,3400,16,395,1635,123,1139,20,186,5626,1005,25,12,301,368,540,3861,13,425,1765,105,882,29,182,6
213,5438,1019,28,20,302,314,535,3438,8,448,2000,103,878,25,186,5234,997,27,13,298,264,485,2993,14,480,2241,101,1012,24,184,8
214,6012,1021,14,7,328,287,454,3250,7,525,2762,130,1009,24,175,4274,924,24,11,277,313,507,2970,13,380,1304,70,613,32,171,12
215,4929,1009,38,19,259,217,415,2255,19,552,2674,126,970,23,217,4341,1026,41,17,248,296,531,2805,24,448,1536,106,935,26,218,10
216,4930,996,25,15,287,287,491,2911,10,458,2019,99,831,19,197,6502,1102,20,10,358,322,521,3848,10,548,2654,93,795,31,203,2
217,6237,999,23,6,345,312,519,3829,17,445,2408,113,1013,31,179,6042,972,24,10,329,318,490,3949,14,451,2093,98,901,28,171,6
218,5028,1036,22,8,271,373,608,3479,14,394,1549,91,895,27,194,5971,1052,19,6,313,347,561,4038,13,464,1933,115,923,23,197,3
219,4432,981,21,9,269,291,514,2820,12,420,1612,121,1136,37,188,5568,1020,31,10,324,352,547,3806,21,438,1762,105,1012,39,187,4
220,6446,1067,20,5,360,399,607,4661,15,443,1785,120,1045,35,198,4883,1031,25,7,311,399,641,3607,18,349,1276,103,816,32,195,12
221,7317,1156,26,16,435,461,675,5444,10,461,1873,117,1000,35,202,5696,1074,26,9,339,357,613,4070,17,420,1626,97,807,41,206,13
222,4659,991,28,12,272,283,527,3006,16,421,1653,124,1038,21,191,5412,1014,30,13,325,285,483,3195,17,504,2217,95,835,27,188,5
223,5991,1050,14,7,348,404,629,4587,7,383,1404,96,860,31,192,5430,1042,21,9,303,361,596,3852,12,397,1578,112,1013,22,190,12
224,5772,1015,30,9,336,310,506,3836,21,472,1936,100,939,32,176,5165,974,31,13,294,301,511,3506,18,429,1659,93,895,27,183,9
225,5618,960,22,11,301,336,547,3979,11,376,1639,124,952,26,192,5115,1039,28,11,299,334,550,3212,17,442,1903,119,1001,33,183,13
226,5192,993,32,9,286,307,550,3567,23,389,1625,106,1004,28,199,5682,1095,19,9,333,340,578,3696,10,475,1986,122,950,41,204,8
227,6161,1028,24,8,331,359,589,4734,16,411,1427,94,795,31,200,6022,1072,31,11,338,361,589,4082,20,435,1940,110,933,25,196,9
228,6540,1160,33,16,382,445,740,4927,17,391,1613,103,944,26,197,5458,998,17,6,305,346,544,3569,11,420,1889,93,789,31,190,4
229,5726,975,23,10,290,335,553,4089,13,384,1637,115,951,21,192,5137,1037,38,13,295,354,580,3462,25,413,1675,104,789,35,197,11
230,6152,1138,20,9,378,380,628,4087,11,470,2065,69,625,43,201,5969,1118,29,12,338,336,589,3824,17,481,2145,110,951,20,196,12
231,5809,980,24,5,339,402,601,4515,19,366,1294,74,546,29,174,5427,1084,26,10,320,372,583,3403,16,467,2024,92,889,11,179,14
232,5729,1047,27,12,323,350,577,3755,15,421,1974,83,649,19,182,4982,979,19,8,279,312,539,3449,11,403,1533,81,616,22,187,8
233,4891,1013,25,9,289,313,488,3153,16,491,1738,70,560,29,176,5306,1020,25,9,312,316,532,3222,16,453,2084,105,843,20,182,10
234,5149,1021,17,11,301,283,487,3190,6,502,1959,121,1006,34,193,4655,963,28,9,273,285,482,2946,19,434,1709,130,1055,36,185,12
235,5193,989,26,10,291,309,542,3587,16,406,1606,129,1141,32,193,6141,1067,33,20,343,324,545,3888,13,485,2253,119,965,32,194,8
236,3926,984,26,11,245,303,513,2406,15,420,1520,75,591,20,186,5208,1013,24,12,296,315,506,3287,12,490,1921,102,772,21,184,4
237,5456,1045,26,13,298,355,562,3619,13,451,1837,95,834,14,189,4898,945,30,8,259,276,475,2997,22,441,1901,88,660,19,192,9
238,4262,975,28,4,250,319,588,2924,24,376,1338,107,859,29,190,5360,997,28,13,298,331,522,3578,15,447,1782,119,953,27,192,5
239,4946,1011,25,12,295,286,477,2890,13,505,2056,114,863,27,177,4822,980,25,6,276,318,547,3249,19,399,1573,99,767,16,185,10
240,5359,1052,29,13,321,369,626,3728,16,392,1631,129,1187,39,191,5147,1030,13,6,305,345,551,3444,7,446,1703,101,948,38,191,3
241,5199,982,27,14,278,347,540,3751,13,401,1448,92,733,21,191,5566,1045,23,7,307,306,531,3420,16,472,2146,100,887,31,195,7
242,4988,976,33,16,298,342,551,3503,17,371,1485,93,779,37,191,5475,1004,19,8,317,319,503,3678,11,462,1797,112,982,24,186,3
243,4635,927,29,11,265,296,478,2989,18,413,1646,78,675,24,177,5601,1041,28,9,317,309,507,3531,19,505,2070,85,741,20,176,5
244,4573,987,26,12,258,278,521,2751,14,423,1822,134,1120,20,189,5904,1036,25,11,317,286,467,3394,14,544,2510,115,981,31,200,4
245,6295,1073,18,7,365,378,574,4258,11,478,2037,93,744,28,184,5746,1002,28,10,322,370,605,3943,18,367,1803,91,838,21,187,11
246,6051,1035,23,8,330,418,632,4553,15,372,1498,97,840,22,175,6372,1038,28,12,358,359,566,4478,16,450,1894,91,744,26,169,6
247,5307,977,19,7,291,365,588,3811,12,344,1496,134,1090,25,187,6019,1076,16,3,351,350,542,4000,13,503,2019,121,1005,36,191,6
248,6179,1070,24,9,371,432,644,4461,15,408,1718,120,953,38,182,5435,997,26,11,315,384,542,3805,15,417,1630,131,1115,25,172,10
249,4631,936,31,10,263,276,466,3015,21,414,1616,91,768,24,198,5029,1002,35,14,282,363,582,3588,21,386,1441,93,790,11,196,11
250,5525,993,18,9,295,298,479,3601,9,471,1924,100,903,14,179,4429,974,35,14,272,363,593,3425,21,333,1004,86,716,29,179,12
251,4693,949,20,7,263,285,505,2916,13,407,1777,121,1000,29,188,5401,1071,24,10,320,328,535,3514,14,498,1887,114,976,35,189,6
252,5044,980,24,8,278,281,471,3005,16,485,2039,94,761,16,191,5124,1013,48,18,297,338,555,3412,30,416,1712,86,665,23,185,11
253,5311,1005,22,9,314,309,493,3141,13,480,2170,97,939,25,171,5089,1000,21,11,312,371,559,3425,10,403,1664,107,880,35,171,9
254,5704,967,31,12,324,347,559,3969,19,380,1735,110,967,19,172,5548,1012,11,3,322,342,530,3598,8,445,1950,103,959,35,174,3
255,4963,949,36,18,271,340,512,3474,18,393,1489,117,916,22,194,4552,961,27,11,258,247,436,2579,16,480,1973,112,897,26,187,5
256,5457,1054,39,16,335,377,600,3961,23,411,1496,92,667,27,197,5052,964,46,22,272,296,510,3072,24,412,1980,114,882,16,194,12
257,5616,1087,21,7,307,288,525,3242,14,534,2374,103,934,18,199,4664,979,30,18,272,269,531,3210,12,408,1454,74,679,33,201,11
258,5243,979,17,7,295,274,470,3027,10,490,2216,106,939,22,179,5688,997,12,6,301,289,486,3491,6,492,2197,94,856,28,179,5
259,5118,1015,22,8,285,308,535,3340,14,455,1778,99,874,32,197,5060,1009,22,12,284,319,539,3385,10,425,1675,101,878,20,200,9
260,4634,988,26,8,271,325,557,3001,18,360,1633,73,573,31,195,5932,1085,20,14,330,355,541,3899,6,499,2033,115,886,23,193,3
261,5687,1038,25,10,313,299,511,3408,15,499,2279,104,807,23,194,4928,976,37,14,292,310,514,3238,23,420,1690,78,720,28,187,7
262,5653,1012,11,4,329,280,427,3093,7,534,2560,111,959,40,181,5653,955,26,14,323,355,546,3842,12,366,1811,108,981,31,176,10
263,5799,1109,27,9,360,339,628,4128,18,440,1671,94,801,42,180,5988,995,15,3,325,334,535,3788,12,428,2200,128,1208,33,180,11
264,4842,1010,16,6,278,289,476,2825,10,487,2017,98,872,24,180,5682,1066,25,7,348,370,573,3688,18,466,1994,97,873,28,183,9
265,6571,1047,26,8,354,413,636,4977,18,398,1594,86,797,19,178,5432,999,22,7,299,299,526,3547,15,445,1885,84,637,19,174,8
266,3970,907,34,19,251,268,470,2642,15,384,1328,98,801,31,168,4940,1047,28,7,321,284,463,2755,21,554,2185,115,981,34,184,4
267,5513,1062,22,9,313,295,485,3352,13,551,2161,94,834,34,194,5571,1077,34,14,329,363,619,3890,20,420,1681,99,786,34,199,9
268,5499,1052,29,10,318,306,563,3685,19,453,1814,98,835,25,193,5756,1035,27,10,329,409,612,4291,17,376,1465,112,907,16,196,6
269,5462,994,24,11,313,327,523,3833,13,435,1629,92,717,25,188,5681,1038,31,12,337,349,555,3818,19,448,1863,97,836,22,186,8
270,5465,1009,23,5,326,380,574,4098,18,398,1367,111,967,37,174,5413,988,18,11,307,320,524,3427,7,438,1986,129,1067,41,179,9
271,5973,1048,14,7,333,379,596,4051,7,434,1922,147,1247,37,194,6001,987,30,14,318,328,541,4120,16,421,1881,115,1062,36,190,12
272,5452,1045,20,8,310,365,604,4030,12,396,1422,118,989,28,179,4815,984,27,7,310,383,592,3706,20,350,1109,99,849,42,182,11
273,5779,1011,21,10,313,265,434,3336,11,560,2443,71,591,25,174,5566,998,18,8,309,325,549,3526,10,415,2040,109,854,12,178,11
274,5396,1029,18,10,323,333,546,3340,8,442,2056,101,774,34,197,5885,1067,36,15,303,334,592,3962,21,428,1923,112,852,26,204,11
275,6085,1035,42,17,331,339,539,3885,25,480,2200,92,777,27,207,4990,974,39,23,263,308,539,3370,16,389,1620,107,899,16,202,10
276,5026,1060,25,7,310,339,598,3640,18,410,1386,110,880,44,202,4973,1008,21,6,283,343,564,3541,15,407,1432,129,1128,28,200,8
277,5387,1032,35,11,312,346,591,3773,24,400,1614,91,897,29,188,5437,988,21,8,295,308,509,3553,13,438,1884,123,1006,20,190,5
278,5571,1025,37,13,314,392,599,4036,24,380,1535,131,941,23,195,5602,1007,27,14,321,314,507,3424,13,459,2178,117,1066,27,193,6
279,5142,1052,30,11,311,355,619,3704,19,396,1438,108,931,39,194,6066,1072,25,8,331,354,585,4114,17,452,1952,133,1168,32,194,8
280,5288,1014,31,14,292,267,452,2956,17,519,2332,90,692,23,190,4679,946,25,13,255,324,530,3449,12,371,1230,109,1002,20,191,10
281,5780,1060,30,12,346,440,652,4314,18,392,1466,68,581,20,180,5570,964,23,10,288,327,524,3924,13,408,1646,89,685,12,182,7
282,5556,1089,31,9,307,371,633,3813,22,414,1743,112,1138,19,201,5081,970,11,4,282,287,484,3123,7,454,1958,103,809,36,194,2
283,5048,981,20,2,288,322,517,3244,18,413,1804,100,836,27,176,5515,1025,19,6,321,353,534,3572,13,450,1943,112,938,32,179,7
284,6332,1070,29,9,351,303,521,3999,20,534,2333,93,880,40,191,4459,918,20,8,235,272,484,2947,12,396,1512,120,1062,22,192,10
285,6092,1088,25,8,366,450,679,4609,17,393,1483,79,709,26,179,5465,1010,21,11,314,356,535,3433,10,445,2032,95,812,13,181,10
286,5368,969,17,5,321,393,585,4094,12,370,1274,86,619,21,150,4975,983,26,11,305,329,481,3009,15,472,1966,68,543,21,153,12
287,5334,1052,29,18,307,319,525,3463,11,498,1871,90,751,12,193,4884,1026,24,10,291,351,602,3424,14,391,1460,88,684,28,193,9
288,5236,1019,19,7,325,375,574,3576,12,404,1660,94,852,33,173,5360,942,14,7,315,323,496,3599,7,403,1761,94,886,36,171,6
289,4135,962,37,16,225,256,484,2289,21,428,1846,106,918,22,197,5374,1060,29,12,328,326,526,3393,17,503,1981,90,765,31,196,2
290,5100,962,17,11,309,320,493,3182,6,420,1918,88,681,33,173,5288,1024,14,8,310,318,545,3252,6,433,2036,107,851,18,178,9
291,4504,961,33,15,276,313,509,2834,18,412,1670,98,767,32,180,4959,994,22,7,283,297,502,2846,15,457,2113,141,1095,23,178,5
292,5931,985,24,9,307,383,578,4334,15,388,1597,113,1006,28,190,5013,994,28,9,297,295,534,3366,19,424,1647,118,908,44,182,13
293,4258,944,33,15,234,255,485,2557,18,410,1701,117,920,22,194,5791,1023,20,12,314,259,438,3303,8,548,2488,86,684,30,193,5
294,4613,945,30,14,285,323,510,3146,16,381,1467,128,1013,33,190,5173,1029,35,11,304,319,533,3332,24,462,1841,137,990,31,189,9
295,4599,934,22,10,266,291,473,2811,12,422,1788,115,943,30,174,5106,1003,22,14,298,343,529,3376,8,432,1730,118,910,33,178,5
296,6109,1013,23,10,344,373,579,4281,13,404,1828,85,708,27,182,6313,1021,28,9,353,315,507,3730,19,483,2583,69,647,22,178,8
297,5502,1013,24,10,331,344,512,3564,14,468,1938,97,796,46,182,4795,1004,36,9,278,377,615,3515,27,339,1280,114,1022,25,185,12
298,6074,1054,18,11,343,377,553,4156,7,467,1918,101,757,24,188,4888,940,24,13,271,341,535,3494,11,357,1394,109,902,25,188,12
299,4722,951,24,11,281,269,475,2818,13,424,1904,118,977,33,182,5187,1005,28,14,310,292,467,3030,14,498,2157,120,1007,28,191,6
300,5583,1056,24,11,323,371,590,3964,13,430,1619,59,428,19,202,5149,1035,34,14,278,333,568,3505,20,422,1644,99,756,17,208,10
301,4053,954,24,11,243,270,449,2237,13,437,1816,106,854,12,173,5824,1012,16,9,348,304,469,3521,7,506,2303,105,846,37,174,2
302,4920,988,44,15,280,325,567,3588,29,381,1332,91,786,27,204,5316,1089,29,12,327,361,601,3573,17,454,1743,105,904,28,200,7
303,6026,1073,21,8,349,365,594,4192,13,453,1834,93,769,34,187,5338,965,29,10,292,340,560,3786,19,372,1552,101,843,19,180,10
304,6533,1041,24,11,373,353,562,4616,13,452,1917,94,758,44,186,5147,982,33,14,284,343,573,3687,19,373,1460,130,1202,28,186,13
305,4309,931,35,16,241,285,561,2921,19,320,1388,108,870,20,190,5977,1092,30,13,339,324,533,3654,17,526,2323,108,894,38,204,5
306,5820,1008,23,6,301,311,566,3983,17,416,1837,101,819,24,193,6078,1031,26,8,329,410,627,4758,18,377,1320,103,851,28,192,7
307,5323,1016,26,10,292,335,540,3578,16,430,1745,99,857,24,195,5115,1034,30,16,307,346,560,3400,14,423,1715,90,779,25,191,10
308,5789,969,16,8,322,289,436,3298,8,492,2491,109,960,22,178,4710,1012,25,11,284,337,567,3203,14,407,1507,93,758,34,180,11
309,6475,968,17,7,379,353,527,4623,10,427,1852,106,801,47,175,5929,1042,36,17,331,364,557,3892,19,440,2037,116,877,19,178,12
310,5069,999,19,6,319,292,473,3043,13,483,2026,80,671,28,170,4820,975,30,10,278,375,563,3429,20,352,1391,84,753,30,178,12
311,6230,1038,25,12,322,348,561,3906,13,428,2324,129,1101,17,196,5235,998,34,11,309,309,536,3469,23,423,1766,87,724,33,194,10
312,4652,939,24,10,238,312,528,3052,14,371,1600,98,758,24,196,5222,1050,33,15,278,352,580,3670,18,426,1552,114,969,25,206,8
313,5018,973,17,8,268,265,453,2819,9,508,2199,108,855,17,191,4698,1022,31,11,276,342,575,3196,20,403,1502,93,750,29,194,13
314,4942,1008,41,13,290,312,574,3228,28,384,1714,110,924,36,186,5250,1026,13,6,315,360,525,3684,7,467,1566,101,906,31,188,0
315,5619,1014,22,9,320,321,510,3419,13,468,2200,115,1094,18,183,4808,991,32,10,280,306,524,3316,22,435,1492,88,741,34,186,9
316,4639,947,32,18,261,262,479,2847,14,427,1792,101,846,26,185,5353,1077,31,6,316,360,573,3591,25,471,1762,104,874,31,191,7
317,5949,1100,24,11,344,442,667,4591,13,393,1358,117,942,35,178,5791,959,20,9,299,328,510,3786,11,417,2005,120,976,28,180,4
318,5002,1022,21,11,287,348,567,3445,10,414,1557,103,789,25,187,4044,963,38,7,236,259,510,2490,31,410,1554,93,749,26,197,12
319,5361,984,22,8,281,353,584,3923,14,376,1438,104,960,25,188,5682,1080,23,12,324,369,591,3629,11,461,2053,99,812,26,187,9
320,6582,1095,30,13,395,456,659,4764,17,406,1818,80,670,36,174,6144,1022,17,5,345,341,546,4019,12,442,2125,105,889,29,171,7
321,4203,960,29,9,245,312,536,2951,20,375,1252,126,1091,26,193,5392,1037,18,8,325,378,582,3732,10,424,1660,108,920,40,192,4
322,5136,1030,30,9,280,210,393,2380,21,607,2756,88,677,17,198,4037,953,31,14,237,259,501,2459,17,420,1578,87,680,22,187,9
323,5424,973,19,10,307,267,420,3236,9,509,2188,128,1183,31,182,4378,990,39,11,282,309,524,2752,28,422,1626,98,879,43,186,13
324,5385,1010,23,13,300,315,519,3356,10,447,2029,70,542,16,176,5637,982,25,10,307,345,510,3774,15,458,1863,64,498,16,168,7
325,5487,1053,31,12,308,356,589,3616,19,420,1871,110,923,23,200,5724,977,30,12,318,333,524,3807,18,421,1917,95,774,30,192,5
326,5568,1008,30,10,320,373,575,4012,20,416,1556,90,670,26,177,5580,1011,35,16,313,353,540,3687,19,449,1893,88,712,15,181,7
327,4397,1023,27,10,269,288,514,2632,17,471,1765,115,1047,22,198,4281,974,26,8,251,294,515,2977,18,419,1304,97,797,31,198,6
328,4923,994,27,10,278,325,539,3264,17,423,1659,103,744,20,197,4737,990,22,8,267,291,500,3000,14,449,1737,89,735,22,195,8
329,6454,1009,21,9,345,407,607,4758,12,379,1696,110,909,30,175,6046,1050,21,8,368,387,589,4130,13,423,1916,100,1023,34,169,8
330,4787,1034,37,18,299,272,493,2891,19,494,1896,83,708,35,194,5174,1019,23,12,293,266,494,3036,11,495,2138,109,805,36,193,6
331,6391,1079,19,7,359,446,651,4918,12,391,1473,95,817,28,181,4891,943,19,7,274,304,507,3105,12,387,1786,91,750,24,181,11
332,5910,1003,18,6,348,339,536,3981,12,446,1929,79,698,27,188,5707,1054,37,12,322,332,565,3363,25,453,2344,95,781,18,190,13
333,4834,907,29,14,252,273,474,3107,15,406,1727,128,1040,24,184,5883,1139,25,8,356,410,625,4032,17,474,1851,114,1039,35,183,6
334,4621,1024,19,6,278,320,570,3090,13,415,1531,95,847,28,180,5318,1035,20,11,301,265,469,2959,9,534,2359,90,726,28,174,4
335,5814,1035,27,13,352,378,605,4366,14,390,1448,104,795,33,175,6049,1011,26,13,327,371,549,4169,13,440,1880,109,937,23,175,5
336,5695,1021,13,3,338,298,491,3177,10,502,2518,102,821,32,178,4672,931,22,5,268,296,503,3139,17,386,1533,111,866,25,173,12
337,5010,957,28,12,260,318,540,3323,16,378,1687,106,847,24,188,5999,1086,24,5,358,374,564,3964,19,483,2035,86,717,26,191,6
338,4974,993,10,5,282,277,451,2930,5,498,2044,113,1014,31,192,4931,974,38,15,267,333,579,3695,23,353,1236,98,867,24,193,13
339,4596,982,31,12,249,292,520,2947,19,417,1649,97,718,14,190,5950,975,26,14,320,278,444,3475,12,501,2475,89,654,16,185,2
340,5616,1048,32,13,324,392,591,4055,19,434,1561,91,730,18,183,4909,963,27,17,279,288,468,2917,10,459,1992,102,746,17,178,10
341,5024,974,25,8,290,306,496,3191,17,443,1833,85,785,36,191,5248,1046,21,9,323,369,605,3828,12,398,1420,119,942,24,185,9
342,5560,1058,28,12,318,361,580,3627,16,451,1933,108,913,27,198,4985,987,45,21,294,287,531,2987,24,413,1998,98,945,29,198,12
343,4488,927,23,11,267,304,510,3122,12,377,1366,110,1027,30,185,5425,1091,14,3,325,336,561,3379,11,489,2046,106,906,41,184,7
344,5547,1060,23,11,347,327,545,3511,12,473,2036,83,756,31,178,5437,999,26,12,309,364,562,3645,14,397,1792,97,760,25,179,7
345,4977,1045,34,12,312,292,512,3054,22,484,1923,94,700,33,197,5285,986,26,14,277,299,504,3256,12,441,2029,118,950,15,196,9
346,4973,1021,28,10,277,299,500,3080,18,487,1893,110,916,25,189,5333,991,26,6,291,257,454,3221,20,508,2112,108,834,26,188,7
347,4960,1034,25,6,281,342,591,3287,19,402,1673,90,789,19,190,4625,1005,27,19,267,279,497,3007,8,461,1618,91,724,29,188,6
348,5602,1015,21,6,320,367,588,3695,15,393,1907,125,985,32,186,5842,1022,28,11,318,353,549,3929,17,429,1913,123,1006,36,185,6
349,4550,1047,29,11,280,299,533,2882,18,475,1668,124,948,42,200,5141,993,30,15,282,271,505,3036,15,450,2105,139,1121,28,203,6
350,5802,1040,16,7,333,345,506,3781,9,472,2021,105,787,37,186,5490,1022,29,14,298,385,594,4167,15,385,1323,117,945,22,187,11
351,6307,1070,12,4,389,389,587,4418,8,448,1889,95,835,50,174,5856,1022,18,6,325,367,590,4020,12,390,1836,111,1035,23,172,13
352,6103,988,24,15,312,323,544,4119,9,416,1984,112,983,17,183,5249,1054,29,10,314,309,525,3067,19,489,2182,96,795,34,186,10
353,6294,1055,24,11,336,333,520,3951,13,493,2343,127,1029,18,183,5356,955,35,7,316,311,531,3477,28,387,1879,90,720,36,178,9
354,3587,865,35,14,191,204,389,1898,21,428,1689,106,780,25,196,6259,1090,26,10,335,374,576,4427,16,486,1832,120,961,15,201,4
355,5915,1107,34,15,329,355,611,3751,19,453,2164,99,802,19,199,5665,993,26,10,329,337,514,3896,16,443,1769,83,697,23,199,3
356,4600,961,34,5,246,279,524,2973,29,404,1627,93,696,18,194,5849,1039,29,10,324,301,482,3318,19,529,2531,80,731,24,190,3
357,4717,1000,37,17,267,260,451,2631,20,508,2086,120,864,23,191,5466,952,26,8,292,261,439,3132,18,486,2334,99,734,15,191,4
358,5310,1000,20,5,287,222,416,2371,15,537,2939,96,877,20,184,5325,994,26,14,313,321,515,3668,12,442,1657,99,799,33,179,7
359,5608,1056,26,10,318,362,606,3911,16,427,1697,74,635,20,200,4389,994,29,14,248,284,525,2913,15,421,1476,81,598,25,198,9
360,5297,1023,31,11,289,264,465,2799,20,525,2498,88,698,14,193,5053,976,37,15,290,305,495,3056,22,450,1997,82,632,26,181,8
361,4122,930,26,10,259,269,459,2515,16,428,1607,120,897,34,177,5496,1030,30,13,343,314,503,3291,17,489,2205,124,904,28,177,5
362,4891,999,25,7,307,352,562,3167,18,386,1724,96,789,32,174,5582,1014,22,11,331,348,513,3789,11,464,1793,94,832,25,174,7
363,4942,1047,38,18,300,344,616,3383,20,387,1559,127,1090,26,196,5320,1060,22,12,314,309,519,3412,10,496,1908,118,983,34,201,4
364,4951,997,23,9,294,316,591,3582,14,361,1369,147,1132,25,183,5292,1029,19,14,299,296,486,3243,5,507,2049,101,825,34,184,4
365,4715,1011,25,6,286,310,512,3014,19,446,1701,63,486,21,171,5310,1016,21,6,315,289,470,3154,15,517,2156,93,761,13,169,4
366,6327,1011,28,7,331,391,590,4603,21,388,1724,94,868,33,190,5809,1055,30,13,327,402,625,4350,17,382,1459,121,1199,25,189,10
367,5153,939,35,13,275,330,582,3858,22,327,1295,134,1013,24,184,5936,1072,18,9,367,315,510,3924,9,537,2012,102,837,42,183,5
368,5458,957,20,8,325,375,586,3954,12,336,1504,102,867,32,183,6645,1094,28,13,388,403,623,4589,15,437,2056,112,875,35,189,8
369,6580,1058,15,6,393,403,586,4731,9,451,1849,78,690,26,167,4613,933,31,12,278,314,526,3041,19,360,1572,96,764,15,175,16
370,4163,971,31,13,237,219,443,2076,18,498,2087,77,678,17,189,6229,1072,19,9,336,313,526,3915,10,506,2314,101,812,27,186,5
371,4463,955,25,12,282,329,481,2778,13,431,1685,90,761,20,169,5400,979,22,11,312,328,505,3444,11,446,1956,96,792,23,168,6
372,5289,1046,34,14,317,365,590,3767,20,428,1522,90,725,26,190,5312,957,26,10,290,326,514,3469,16,416,1843,95,776,23,182,4
373,5575,1075,37,16,304,419,670,4437,21,360,1138,145,1184,22,194,4729,936,26,11,272,301,488,3097,15,411,1632,103,819,31,198,5
374,5529,965,13,6,308,330,491,3632,7,448,1897,81,669,13,174,5264,979,30,12,296,320,551,3644,18,388,1620,86,615,27,165,11
375,5170,1040,31,10,300,335,557,3527,21,445,1643,72,595,20,185,4949,988,19,8,264,288,502,3348,11,447,1601,85,730,14,181,7
376,5542,996,18,10,328,288,450,3357,8,525,2185,108,875,37,179,5360,991,33,10,320,372,607,4053,23,355,1307,109,940,41,183,12
377,4382,911,30,11,233,256,441,2515,19,424,1867,107,855,26,188,5449,1086,33,5,310,295,519,2948,28,535,2501,107,919,19,192,6
378,5674,1039,26,10,306,279,491,3180,16,504,2494,148,1276,34,203,5165,991,24,12,292,249,470,3027,12,474,2138,117,1161,44,205,8
379,6058,1035,16,8,335,333,489,3790,8,500,2268,117,1007,17,174,4668,947,23,9,273,333,548,3364,14,362,1304,94,795,27,174,10
380,6274,1102,34,15,350,371,634,4482,19,445,1792,110,925,23,196,5546,982,22,7,290,338,572,3950,15,377,1596,87,681,31,199,7
